1111111111111111111111111111111111
1E000P000000000C00100C000010000001
1010010100100000101001000000010101
1010010010101010001001000100010101
100000000C00C00E0000000100000000C1
1010010010101010001001000100010101
1C100100C01000100010010C0100010101
1111111111111111111111111111111111