1111111111111111111111111111111111
1E0000010000000C00000C000010000001
1010010100100000101001000000010101
1010010010101010001001000100010101
110000000C00C00E0100100000100000C1
1010010010101010001001000000010101
101001001010101C001001000100010101
1000000001010100000100100000001001
1C1011000C100010C010010001000101P1
1111111111111111111111111111111111